1111111111111
10010000C0001
1000011111001
10P011E000011
1111111111111