1111111111111111111111
1000000000000100000001
100000000000000010P001
1000000100000000C0CC01
100000000010C00C010001
1010000000000000000001
1000000C0000E000000101
1111111111111111111111