11111111111111111111
10000000000000001111
100P00000000000000C1
10000000000000001111
11111111101111111111
100001000C0000000001
10001001000001000001
110000000000000C0101
10E000001C10001C0001
10000001000100000001
11111111111111111111